NO ./textures/42N.xpm
SO ./textures/42S.xpm
WE ./textures/42W.xpm
EA ./textures/42E.xpm

F 50,150,150
C 100,100,254


    111111111111111111111111
    100000000000000000000001
    100000000000000000000111
1111100000000000000000001
100000000000000000000001
100000000000W00000000001
100000000000000000000001
100000000000000000000001
100000000000000000000001
111111111111111111111111
