NO ./textures/42N.xpm
SO ./textures/42S.xpm
WE  ./textures/42W.xpm
EA ./textures/42E.xpm

F 238,173,14
C 238,92,66

                 11111
        111111111111111111111111
        10N00W0000110000000000001
        101100000111000000000001
        1001000000000000000000001
111111111011000001110000000000001
100000000011000001110111111111111
11110111111111011100000010001
1110111111111011101010010001
11000000110101011100000010001
100000000000000001100000010001
10000000000000001101010010001
110000011010100111101111000111
11110111 1110101 101111010001
11111111 1111111 111111111111