NO ./textures/42N.xpm
SO ./textures/42S.xpm
WE ./textures/42W.xpm
EA ./textures/42E.xpm

F 238,173,14
C 238,92,66


    111111111111111111111111
    1000000000000000000001
    1000000000000000000111
1111100000000000000000001
100000000001111000000001
100000000000W01000000001
100000000000011000000001
10000000000000000000001
100000000000000000000001
111111111111111111111111