NO    ./textures/42N.xpm

WE   ./textures/42W.xpm        



SO    ./textures/42S.xpm


EA     ./textures/42E.xpm


F    000000000252,212,13


C       000000000012,000000024,000000124

        1111111111111111111111111
        1011000001110000000000001
        1001000000000000000000001
111111111011000001110000000000001
100000000011000001110111110111111
11110111111111011100000010001
11110111111111011101010010001
11000000110101011100000010001
10000000000000001100000010001
10000000000000001101010010001
11000001110101011111011110N0111
11110111 1110101 101111010001
11111111 1111111 1111111111111