NO ./textures/42N.xpm
SO ./textures/42S.xpm
WE ./textures/42W.xpm
EA ./textures/42E.xpm

F 000,255,000255
C 23,92,66







        1111111111111111111111111
        1000000101110000000000001
        1011000101110000000000001
        1001000101000000000000001
111111111011000101110000000000001
100000000011000101110111110111111
11110111111111010100000010001
11110111111111011101010010011
11111111111111111111111111111
1111111111111111111111111111111
1100000011010101 10000001000111
1000000000000001110000001000001
1000000000000000000101001010101
11000001110101010111011111W1101
11110111 1110101010111101000001
11111111 1111111111111111111111